B@@XXXXXXXXXXXX
XX@XXX@@@@@XXXX
X@@@@@@X@XXXXXX
XXX@X@X@@@@@XXX
XXX@XXXXXXX@XXX
XXX@XXXX@@@@XXX
XXX@XXX@@XX@XX@
XXX@XXX@@XXXX@@
X@@@XXX@@XXXX@@
XXX@@@@@XXXX@@@
XX@X@XXXXXX@@@@
XX@@@@@@@XX@@@@
XXX@XXXX@@@@XXX
XXX@@@@@@XX@@@X
XXXXXXXAXXXXXXX